alwaysday - 锁定或解锁日夜循环
camera - 修改玩家的相机视角
camerashake - 对玩家视野施以一定强度和时间的摇晃效果
clear - 清除玩家物品栏的物品
clearspawnpoint - 清除世界中设置的重生点
clone - 在指定区域之间复制方块结构
damage - 对指定实体造成伤害
daylock - 锁定或解锁日夜循环
deop - 撤销玩家的管理员权限
dialogue - 为玩家打开NPC的对话框
difficulty - 设定难度等级
effect - 管理玩家及其他实体上的状态效果
enchant - 为一位玩家手持的物品添加魔咒
event - 触发实体事件
execute - 在改变执行者、执行位置和角度，添加限制条件，并储存其输出值的情况下执行另一条命令
fill - 用特定方块填充一个区域的全部或部分
fog - 更改玩家的迷雾效果
function - 运行行为包内的1个函数
gamemode - 设置玩家的游戏模式
gamerule - 设置或查询游戏规则
gametest - 基于测试代码与测试结构配对的服务端测试自动化工具
give - 给予实体一种指定数量的物品
help - 列出所有可用命令
hud - 修改HUD可见性
immutableworld - 设置世界是否可发生变化
inputpermission - 对玩家的权限状态进行指定操作
kick - 将一位玩家踢出服务器
kill - 杀死/清除实体（玩家、生物等）
list - 列出在服务器上的玩家
listd - 列出在服务器上的玩家（隐藏命令）
locate - 在聊天框中为命令执行者显示给定类型结构或生物群系的最近坐标和距离
loot - 将指定的战利品放入物品栏或世界
me - 显示一条关于你自己的信息
mobevent - 控制或查询允许运行的生物事件
msg - 将一条私聊信息发送给一个或多个玩家
music - 控制音乐
op - 授予玩家管理员权限
particle - 在指定位置显示粒子效果
playanimation - 用于使一个或多个实体运行一次性动画
playsound - 播放一段声音
recipe - 给予或剥夺（解锁或锁定）玩家的合成配方
reload - 重新加载行为包中的函数和脚本
replaceitem - 替换方块或实体物品栏内的物品
ride - 用于使实体骑乘其他实体、停止实体的骑乘/使坐骑逐出自己的骑手、召唤坐骑/骑手
save - 准备备份、查询存档状态或恢复存档
say - 通过聊天框向多个玩家发送消息
schedule - 在指定的区域全部被加载时执行函数
scoreboard - 管理记分板的目标、玩家和队伍
script - 调试GameTest框架选项
scriptevent - 通过ID和消息来触发脚本事件
setblock - 将指定位置的方块更改为另一个方块
setmaxplayers - 设置可加入多人游戏的玩家数量上限
setworldspawn - 设置世界出生点
spawnpoint - 为特定玩家设置出生点
spreadplayers - 把实体随机传送到区域内地表的某个位置
stopsound - 停止声音播放
structure - 保存或加载结构
summon - 召唤一个实体
tag - 管理实体的记分板标签
teleport - 传送实体到指定地点，并修改其旋转角度
tell - 将一条私聊信息发送给一个或多个玩家
tellraw - 向一个或多个玩家发送一条JSON文本消息
testfor - 检测并统计符合指定条件的实体
testforblock - 探测某个方块是否在特定位置
testforblocks - 测试两个区域中的方块是否相同
tickingarea - 添加、删除或列出常加载区域
time - 更改或查询世界的游戏时间
title - 控制屏幕标题
titleraw - 控制屏幕标题(JSON)
toggledownfall - 切换天气
tp - 传送实体到指定地点，并修改其旋转角度
volumearea - 在当前维度中添加、移除或列出功能域
w - 将一条私聊信息发送给一个或多个玩家
wb - 启用或禁用worldbuilder（世界建造者）能力
weather - 更改游戏中的天气
worldbuilder - 启用或禁用worldbuilder（世界建造者）能力
xp - 给予玩家经验
? - 列出所有可用命令
